###################################################
BBBBBBBBBBBWBBBBBBBBBBBBBBBBBBB                   #
BBBBBBBBBBWWBBBBBBBBBBBBBBBBBBB R     G C         #
BBBBBBBBBBWWWBBBBBBBBBBBBBBBBBBR RY YGGGCCCBBBW W #
#WWWWBWBBBWWBBBBBBBBBBBBBBBBBBBRRRY Y G C CB BWW  #
WWWWWWWBB#WW#BBBBBBBBBBBBBBBBBBR RYYY G C CBBBW   #
WWWWWWWBB#####BWWWWWWWW#BBBBBBB                   #
WWWWWWWBBBWWWBBWWWWWWWWWWWWW#BB                   #
BBWWWWWBBWWWWWBWWWWWWWWWWBBBBBB      WWW          #
BBW#WWWB#WWWWWBWWWWWWW#BBBBBBWB        W WWW W W  #
BBWWWWW#WWWWWWBWWWWBBBBBBBWWWWB       W  W W W W  #
BBW#WWWWWWWWWWBW#BBBBWWBBWWWWWB      WWW WWW WWW  #
BBBBWWWWWWWWWBBBBBWBBBBWWWWWWWB                   #
BBBBWWWWW#BBBBBWBBWB#WWBWWWWWBB        W       W  #
BBB#WWW#BBBBBWB#BBWBBWWWWWWWWBB        WWW W W    #
BBB#BBBBBWWWWW#B#BWBBBB#WWWWWBB        W W W W W  #
BBBBBBBWWBWWWWWW##WBBBBWWWWWWBB        W W WWW W  #
BBBBBWWWBBWWWWWWWWWBBB#WWWWWBBB                   #
BBBBWWWWBBWWWW##WWWWWWWWWWWBBBB    W              #
BBB#WWWWBBWWWWBWWWWWWWWWWWWBBBB  WWW WWW WWW  WW  #
BBB#WWWWBBWWWWBWWWWWWWWWWWWBBBB  W W W W W W W W  #
BBBWWWWBBBWWWWWWWWWWWWWBBBBBBBB  WWW WWW W W WWW  #
BBBWWWWBBBWWW#WBWWBBBBBBBBBBBBB                W  #
BBBWWWWBBB#WWBBWBBBBBBBBBBBBBBB             W  W  #
BBBWWWWBBBWWBBBBBBBBBBBBBBBBBBB              WW   #
BBBBBBBBBBWWBBBBBBBBBBBBBBBBBBB                   #
BBBBBBBBBBWWBBBBBBBBBBBBBBBBBBB                   #
BBBBBBBBBBWWBBBBBBBBBBBBBBBBBBB                   #
BBBBBBBBB#WWBBBBBBBBBBBBBBBBBBB  ##################
BBBBBBBBBWWWWBBBBBBBBBBBBBBBBBB                    
BBBBBBBBBBBBBBBBBBBBBBBBBBBBBBB                    